1111111111111111111
1P0000000000C00X001
1010010100000000001
1010010010101000111
100000X0000000000E1
1111111111111111111
